0013004444
0444000200
0444444430
4044020000
3103044444
4444444444